10 10 1 2 9 8
9 1 5 3 9 5 5 1 1 3
12 0 5 6 12 7 9 0 0 6
11 10 13 1 1 5 6 10 8 3
10 12 3 10 10 9 5 2 10 10
8 3 10 14 8 0 3 12 0 2
10 12 6 9 4 0 4 5 6 10
10 13 1 2 9 6 9 3 9 6
12 3 8 0 4 5 2 10 12 3
11 10 12 6 9 1 0 0 1 2
12 4 5 5 6 12 4 4 4 6
0 0 7 -1 8 0 -1 0 -3 0
0 3 0 0 -2 0 0 -2 0 0
0 0 0 -2 -2 0 0 -2 0 0
0 0 0 8 0 0 0 0 0 0
0 0 -5 0 0 0 0 0 -4 0
0 0 9 0 0 0 -5 0 0 0
0 0 0 0 0 0 0 7 6 0
2 0 0 -4 -2 0 0 0 0 9
0 1 -4 0 0 0 0 -4 8 0
5 0 0 1 0 -3 0 -4 0 0